111111111111
1C0P0000C001
10000C000001
1C00000000E1
111111111111
